{
  "keys": {
    "1": "1",
    "2": "2",
    "3": "3",
    "4": "4",
    "5": "5",
    "6": "6",
    "7": "7",
    "8": "8",
    "9": "9",
    "0": "0",
    "`": "`",
    "-": "-",
    "=": "=",
    "q": "𐑶",
    "w": "𐑢",
    "e": "𐑧",
    "r": "𐑮",
    "t": "𐑑",
    "y": "𐑭",
    "u": "𐑳",
    "i": "𐑦",
    "o": "𐑪",
    "p": "𐑐",
    "[": "[",
    "]": "]",
    "a": "𐑩",
    "s": "𐑕",
    "d": "𐑛",
    "f": "𐑓",
    "g": "𐑜",
    "h": "𐑣",
    "j": "𐑘",
    "k": "𐑒",
    "l": "𐑤",
    ";": ";",
    "z": "𐑟",
    "x": "𐑻",
    "c": "𐑗",
    "v": "𐑝",
    "b": "𐑚",
    "n": "𐑯",
    "m": "𐑥",
    ",": ",",
    ".": ".",
    "/": "/",
    "Q": "𐑬",
    "W": "𐑾",
    "E": "𐑱",
    "R": "𐑸",
    "T": "𐑔",
    "Y": "𐑷",
    "U": "𐑫",
    "I": "𐑰",
    "O": "𐑴",
    "P": "𐑹",
    "A": "𐑨",
    "S": "𐑖",
    "D": "𐑼",
    "F": "𐑲",
    "G": "·",
    "H": "𐑞",
    "J": "𐑡",
    "Z": "𐑠",
    "X": "𐑺",
    "C": "𐑽",
    "V": "𐑿",
    "B": "⸰",
    "N": "𐑙",
    "M": "𐑵",
    " ": " ",
    "\\": "\\"
  },
  "autoLigatures": "optional",
  "ligatures": {
    "𐑼": [
      [
        "𐑩",
        "𐑮"
      ]
    ],
    "𐑸": [
      [
        "𐑭",
        "𐑮"
      ]
    ],
    "𐑹": [
      [
        "𐑷",
        "𐑮"
      ]
    ],
    "𐑿": [
      [
        "𐑘",
        "𐑵"
      ]
    ],
    "𐑽": [
      [
        "𐑾",
        "𐑮"
      ]
    ],
    "𐑻": [
      [
        "𐑦",
        "𐑮"
      ]
    ],
    "𐑺": [
      [
        "𐑺",
        "𐑮"
      ]
    ]
  }
}