{
  "keys": {
    "q": "𐑵",
    "w": "𐑧",
    "e": "𐑨",
    "r": "𐑭",
    "t": "𐑬",
    "y": "·",
    "u": "𐑝",
    "i": "𐑢",
    "o": "𐑞",
    "p": "𐑣",
    "[": "[",
    "]": "]",
    "a": "𐑤",
    "s": "𐑦",
    "d": "𐑩",
    "f": "𐑯",
    "g": "𐑷",
    "h": "𐑖",
    "j": "𐑑",
    "k": "𐑕",
    "l": "𐑒",
    ";": "𐑐",
    "z": "𐑪",
    "x": "𐑳",
    "c": "𐑼",
    "v": "𐑴",
    "b": "«",
    "n": "»",
    "m": "𐑗",
    ",": ",",
    ".": ".",
    "/": "/",
    "Q": "𐑿",
    "W": "𐑱",
    "E": "𐑲",
    "R": "𐑸",
    "T": "𐑶",
    "U": "𐑓",
    "I": "𐑘",
    "O": "𐑔",
    "P": "𐑙",
    "A": "𐑮",
    "S": "𐑰",
    "D": "𐑾",
    "F": "𐑥",
    "G": "𐑹",
    "H": "𐑠",
    "J": "𐑛",
    "K": "𐑟",
    "L": "𐑜",
    ":": "𐑚",
    "Z": "𐑺",
    "X": "𐑻",
    "C": "𐑽",
    "V": "𐑫",
    "M": "𐑡",
    "1": "1",
    "2": "2",
    "3": "3",
    "4": "4",
    "5": "5",
    "6": "6",
    "7": "7",
    "8": "8",
    "9": "9",
    "0": "0",
    "`": "`",
    "-": "-",
    "=": "=",
    " ": " ",
    "\\": "\\"
  },
  "autoLigatures": "never",
  "ligatures": {}
}