{
  "keys": {
    "q": "𐑱",
    "w": "𐑧",
    "e": "𐑰",
    "r": "𐑥",
    "t": "𐑒",
    "y": "𐑐",
    "u": "𐑑",
    "i": "𐑛",
    "o": "𐑓",
    "p": ";",
    "[": "[",
    "]": "]",
    "a": "𐑪",
    "s": "𐑨",
    "d": "𐑩",
    "f": "𐑦",
    "g": "𐑳",
    "h": "𐑤",
    "j": "𐑮",
    "k": "𐑕",
    "l": "𐑯",
    ";": "𐑢",
    "z": "𐑲",
    "x": "𐑴",
    "c": "𐑞",
    "v": "𐑟",
    "b": "𐑣",
    "n": "𐑝",
    "m": "𐑚",
    ",": ",",
    ".": ".",
    "/": "/",
    "Q": "𐑬",
    "W": "𐑹",
    "E": "𐑸",
    "R": "𐑿",
    "T": "𐑜",
    "U": "𐑗",
    "I": "𐑡",
    "A": "𐑷",
    "S": "𐑭",
    "D": "𐑩",
    "F": "𐑵",
    "G": "𐑫",
    "H": "·",
    "J": "𐑮",
    "K": "𐑖",
    "L": "𐑙",
    ":": "𐑘",
    "Z": "𐑶",
    "C": "𐑔",
    "V": "𐑠",
    "1": "1",
    "2": "2",
    "3": "3",
    "4": "4",
    "5": "5",
    "6": "6",
    "7": "7",
    "8": "8",
    "9": "9",
    "0": "0",
    "`": "`",
    "-": "-",
    "=": "=",
    " ": " ",
    "\\": "\\"
  },
  "autoLigatures": "always",
  "ligatures": {
    "𐑼": [
      [
        "𐑩",
        "𐑮"
      ]
    ],
    "𐑸": [
      [
        "𐑭",
        "𐑮"
      ]
    ],
    "𐑹": [
      [
        "𐑷",
        "𐑮"
      ]
    ],
    "𐑿": [
      [
        "𐑘",
        "𐑵"
      ]
    ],
    "𐑽": [
      [
        "𐑾",
        "𐑮"
      ]
    ],
    "𐑻": [
      [
        "𐑳",
        "𐑮"
      ]
    ],
    "𐑺": [
      [
        "𐑱",
        "𐑮"
      ]
    ],
    "𐑾": [
      [
        "𐑦",
        "𐑩"
      ]
    ]
  }
}